[level]
tileset = maps/centropokemon.png
map = ######################
      ######################
      #.....###########.....
      ......###########.....
      ......###########.....
      .........MMM..........
      #.....................
      ###...................
      ###..............##...
      ###..............##...
      ..........I...........
      #.........CC..........
scale = 1
velocidad = 0
iniciox = 3
inicioy = 0

[.]
name = floor
tile = 0, 3

[#]
name = wall
wall = True

[E]
name = exit
state = False

[P]
name = curar_pokemon
state = False
