[level]
tileset = maps/centropokemon.png
map = ######################
      ######################
      #.....###########.....
      ......###########.....
      ......###PPP#####.....
      ......................
      #.....................
      ###...................
      ###..............##...
      ###..............##...
      ..........I...........
      #.........EE..........
scale = 1
iniciox = 3
inicioy = 0

[.]
name = floor
tile = 0, 3

[#]
name = wall
wall = True

[E]
name = exit
state = False

[P]
name = curar_pokemon
state = False
