[level]
tileset = maps/interior.png
map = ################
      ################
      ################
      ######..........
      .............I..
      ................
      ........##......
      ........##......
      ................
      #..............#
      #..............#
      #.....EE.......#
scale = 1

[.]
name = floor
tile = 0, 3

[#]
name = wall
wall = True

[E]
name = exit
state = False

[I]
name = inicio
state = True
