[level]
tileset = maps/laboratorio.png
map = ###################
      ###################
      #########....######
      #..................
      ##.......O.........
      #####.......#####..
      #####.......#PPP#..
      .####.......#####..
      ...................
      ...................
      ########....#######
      ########....#######
      ########....#######
      ########....#######
      ...................
      ...................
      ##................#
      ##................#
      #........EE.......#
scale = 1

[.]
name = floor
tile = 0, 3

[#]
name = wall
wall = True

[O]
name = profesorOak

[P]
name = pokebola
state = True

[E]
name = exit
state = False
