[level]
tileset = maps/laboratorio.png
map = ###################
      ###################
      #########....######
      #.................#
      ##.......O........#
      #####.......#####.#
      #####.......#PPP#.#
      #####.......#####.#
      #.................#
      #.................#
      ########....#######
      ########....#######
      ########....#######
      ########....#######
      #.................#
      #.................#
      ##................#
      ##.......I........#
      #########EE########
scale = 1
velocidad = 1
iniciox = 1
inicioy = 7

[.]
name = floor
tile = 0, 3

[#]
name = wall
wall = True

[O]
name = profesorOak

[P]
name = pokebola
state = True

[E]
name = exit
state = False
