[level]
tileset = maps/tienda.png
map = ################
      ################
      ################
      #####V.....#####
      #####V..........
      #####V.....##..#
      ######.....##..#
      ...........##..#
      .####......##..#
      .####......##..#
      ................
      #.....EE.......#
scale = 1

[.]
name = floor
tile = 0, 3

[#]
name = wall
wall = True

[E]
name = exit
state = False

[V]
name = vender
state = False
